{
	"actors":[
		{
			"type":"Actor",
			"name":"tile01",
			"tag":"Ground",
			"prefab":true,
			"transform":{
				"scale":[
					2,
					2
				]
			},
			"components":[
				{
					"type":"SpriteComponent",
					"texture_name":"Textures/tileset2_32x32.png",
					"source":[
						96,
						416,
						32,
						32
					]
				},
				{
					"type":"RBPhysicsComponent",
					"data.is_dynamic":false
				},
				{
					"type":"CollisionComponent"
				}
			]
		},
		{
			"type":"Actor",
			"name":"tile02",
			"tag":"Ground",
			"prefab":true,
			"transform":{
				"scale":[
					2,
					2
				]
			},
			"components":[
				{
					"type":"SpriteComponent",
					"texture_name":"Textures/tileset2_32x32.png",
					"source":[
						0,
						128,
						32,
						32
					]
				},
				{
					"type":"RBPhysicsComponent",
					"data.is_dynamic":false
				},
				{
					"type":"CollisionComponent"
				}
			]
		},
		{
			"type":"Actor",
			"name":"tile03",
			"tag":"Ground",
			"prefab":true,
			"transform":{
				"scale":[
					2,
					2
				]
			},
			"components":[
				{
					"type":"SpriteComponent",
					"texture_name":"Textures/tileset2_32x32.png",
					"source":[
						416,
						0,
						32,
						32
					]
				},
				{
					"type":"RBPhysicsComponent",
					"data.is_dynamic":false
				},
				{
					"type":"CollisionComponent"
				}
			]
		},
		{
			"type":"Actor",
			"name":"World",
			"transform":{
				"position":[
					-32,
					-512
				]
			},
			"components":[
				{
					"type":"TilemapComponent",
					"num_columns": 31,
					"num_rows": 20,
					"size": [64, 64],
					"tile_names": ["", "tile01", "tile02", "tile03"],
					"tiles": [
							1, 0, 0, 0, 0, 0, 0, 0, 0, 0, 0, 0, 0, 0, 0, 0, 0, 0, 0, 0, 0, 0, 0, 0, 0, 0, 0, 0, 0, 0, 1,
							1, 0, 0, 0, 0, 0, 0, 0, 0, 0, 0, 0, 0, 0, 0, 0, 0, 0, 0, 0, 0, 0, 0, 0, 0, 0, 0, 0, 0, 0, 1,
							1, 0, 0, 0, 0, 0, 0, 0, 0, 0, 0, 0, 0, 0, 0, 0, 0, 0, 0, 0, 0, 0, 0, 0, 0, 0, 0, 0, 0, 0, 1,
							1, 0, 0, 0, 0, 0, 0, 0, 0, 0, 0, 0, 0, 0, 0, 0, 0, 0, 0, 0, 0, 0, 0, 0, 0, 0, 0, 0, 0, 0, 1,
							1, 0, 0, 0, 0, 0, 0, 0, 0, 0, 0, 0, 0, 0, 0, 0, 0, 0, 0, 0, 0, 0, 0, 0, 0, 0, 0, 0, 0, 0, 1,
							1, 0, 0, 0, 0, 0, 0, 0, 0, 0, 0, 0, 0, 0, 0, 0, 0, 0, 0, 0, 0, 0, 0, 0, 0, 0, 0, 0, 0, 0, 1,
							1, 0, 0, 0, 0, 0, 0, 0, 0, 0, 0, 0, 0, 0, 3, 3, 3, 0, 0, 0, 0, 0, 0, 0, 0, 0, 0, 0, 0, 0, 1,
							1, 0, 0, 0, 0, 0, 0, 0, 0, 0, 0, 0, 0, 0, 0, 0, 0, 0, 0, 0, 0, 0, 0, 0, 0, 0, 0, 0, 0, 0, 1,
							1, 0, 0, 3, 3, 3, 0, 0, 0, 0, 0, 0, 0, 0, 0, 0, 0, 0, 0, 0, 0, 0, 0, 0, 0, 0, 0, 0, 0, 0, 1,
							1, 0, 0, 0, 0, 0, 0, 0, 0, 0, 0, 0, 0, 0, 0, 0, 0, 0, 0, 0, 0, 0, 0, 0, 0, 0, 0, 0, 0, 0, 1,
							1, 0, 0, 0, 0, 0, 0, 0, 0, 0, 0, 0, 0, 0, 0, 0, 3, 3, 3, 0, 0, 0, 0, 3, 3, 3, 0, 0, 0, 0, 1,
							1, 0, 0, 0, 0, 0, 0, 0, 0, 0, 0, 0, 0, 0, 0, 0, 0, 0, 0, 0, 0, 0, 0, 0, 0, 0, 0, 0, 0, 0, 1,
							1, 0, 0, 0, 0, 0, 0, 0, 0, 0, 3, 3, 3, 0, 0, 0, 0, 0, 0, 0, 0, 0, 0, 0, 0, 0, 0, 0, 0, 0, 1,
							1, 0, 0, 0, 0, 0, 0, 0, 0, 0, 0, 0, 0, 0, 0, 3, 3, 3, 0, 0, 0, 0, 0, 0, 0, 0, 0, 0, 0, 0, 1,
							1, 0, 0, 0, 0, 0, 0, 0, 0, 0, 0, 0, 0, 0, 0, 0, 0, 0, 0, 0, 0, 0, 0, 0, 0, 0, 0, 0, 0, 0, 1,
							1, 0, 0, 0, 0, 3, 3, 3, 0, 0, 0, 0, 0, 0, 0, 0, 0, 0, 0, 3, 3, 3, 0, 0, 0, 0, 3, 3, 3, 0, 1,
							1, 3, 3, 0, 0, 0, 0, 0, 0, 0, 3, 3, 3, 0, 0, 0, 0, 0, 0, 0, 0, 0, 0, 0, 0, 0, 0, 0, 0, 0, 1,
							1, 0, 0, 0, 0, 0, 0, 0, 0, 0, 0, 0, 0, 0, 0, 0, 0, 0, 0, 0, 0, 0, 0, 0, 0, 0, 0, 0, 0, 0, 1,
							1, 2, 2, 2, 2, 2, 2, 2, 2, 2, 2, 2, 2, 2, 2, 2, 2, 2, 2, 2, 2, 2, 2, 2, 2, 2, 2, 2, 2, 2, 1, 
							1, 1, 1, 1, 1, 1, 1, 1, 1, 1, 1, 1, 1, 1, 1, 1, 1, 1, 1, 1, 1, 1, 1, 1, 1, 1, 1, 1, 1, 1, 1
							]
				}    
			]
		}
	]
}